20 20
WWWWWWWWWWWWWWWWWWWW
W..................W
W..................W
W..................W
W.....#............W
WWWWWWWWW..........W
W..................W
W..................W
W..........W.......W
W..........W.......W
W......WWWWW.......W
W..................W
W..................W
W..W...............W
W..WWWWWW..........W
W..................W
W.....WWWWWW.......W
W..................W
W..............*...W
WWWWWWWWWWWWWWWWWWWW
0 0 1 1
