20 20
WWWWWWWWWWWWWWWWWWWW
W..W#..............W
WWWWWWWW...........W
W..................W
W..................W
W..................W
W..................W
W..................W
W......GGG.........W
W......GGG.........W
W..................W
W..................W
W..................W
W..................W
W..................W
W..................W
W..................W
W...GG.............W
W.*.GG.......W.....W
WWWWWWWWWWWWWWWWWWWW
5 5 5 5

