20 20
WWWWWWWWWWWWWWWWWWWW
W..................W
W..................W
W#.................W
WWW................W
W..................W
W..................W
W..................W
W..................W
W..................W
W..................W
W..................W
W..................W
W..................W
W..................W
W..................W
W..................W
W..................W
W............*.....W
WWWWWWWWWWWWWWWWWWWW
5 5 5 5

