5 20
WWWWWWWWWWWWWWWWWWWW
W...SGSGSGSGSGSG...W
W...*S*S*S*S*S*S...W
W#..SSSSSSSSSSSS..*W
WWWWWWWWWWWWWWWWWWWW
5 5 5 5
