20 20
WWWWWWWWWWWWWWWWWWWW
W..................W
W..#...............W
WWWWWW.............W
W.....W............W
W......W...........W
W......W...........W
W.......W..........W
W.......W..........W
W.......W..........W
W........W.........W
W........W.........W
W........W.........W
W........W.........W
W.........W........W
W.........W........W
W.........W........W
W.........W........W
W*.................W
WWWWWWWWWWWWWWWWWWWW
5 5 5 5